7,7,7,7,7,7,12,1,13,7,7,7,7,7,7
1,1,1,1,1,1,1,1,1,1,1,1,1,1,1
6,6,6,6,6,6,11,1,10,6,6,6,6,6,6
0,0,0,0,0,0,4,1,5,0,0,0,0,0,0
0,0,0,0,0,0,4,1,5,0,0,0,0,0,0
0,0,0,0,0,0,4,1,5,0,0,0,0,0,0
0,0,0,0,0,0,4,1,5,0,0,0,0,0,0
0,0,0,0,0,0,4,1,5,0,0,0,0,0,0
0,0,0,0,0,0,2,6,9,0,0,0,0,0,0
0,0,0,0,0,0,0,0,0,0,0,0,0,0,0
0,0,0,0,0,0,0,0,0,0,0,0,0,0,0
0,0,0,0,0,0,0,0,0,0,0,0,0,0,0
0,0,0,0,0,0,0,0,0,0,0,0,0,0,0
0,0,0,0,0,0,0,0,0,0,0,0,0,0,0
0,0,0,0,0,0,0,0,0,0,0,0,0,0,0